


s              s
x              x
x              x
x              x
x              x
xx            xx
xxx      l   xxx
xxxxxxxxxxxxxxxx
  xxxxxxxxxxxxxxx
